111111111111111111
1101100110000E0P11
100100110011000011
100C0C00C10C00C011
111111111111111111